적 캐릭터수 : 9
3 1
타입인덱스: 0 적캐릭터 생성 인덱스: 2 출현 시간: 100
9 1
타입인덱스: 1 적캐릭터 생성 인덱스: 0 출현 시간: 200
21 1
타입인덱스: 0 적캐릭터 생성 인덱스: 1 출현 시간: 300
7 5
타입인덱스: 0 적캐릭터 생성 인덱스: 3 출현 시간: 300
16 6
타입인덱스: 1 적캐릭터 생성 인덱스: 4 출현 시간: 300
7 9
타입인덱스: 0 적캐릭터 생성 인덱스: 5 출현 시간: 350
1 11
타입인덱스: 1 적캐릭터 생성 인덱스: 6 출현 시간: 360
21 12
타입인덱스: 1 적캐릭터 생성 인덱스: 7 출현 시간: 500
1 16
타입인덱스: 0 적캐릭터 생성 인덱스: 8 출현 시간: 550
보스 초기 위치 : 12 16
플레이어 초기 위치 : 11 14
2 2 2 2 2 2 2 2 2 2 2 2 2 2 2 2 2 2 2 2 2 2 2 
2 0 0 3 0 0 1 0 0 3 0 0 2 0 0 0 0 0 0 0 0 3 2 
2 0 0 0 0 0 1 0 0 0 0 0 2 0 0 0 0 0 0 0 0 0 2 
2 2 2 0 0 0 0 0 0 0 0 0 2 0 0 0 1 1 1 0 0 0 2 
2 0 0 0 0 0 0 0 0 0 0 0 2 0 0 0 1 1 1 0 0 0 2 
2 0 0 0 0 0 0 3 0 0 0 2 2 2 0 0 0 0 0 0 0 0 2 
2 1 1 0 0 0 2 0 0 0 0 0 0 0 0 0 3 0 0 0 0 0 2 
2 0 0 0 0 0 0 1 1 0 0 0 0 0 0 0 0 0 0 0 0 0 2 
2 0 0 0 0 0 0 0 0 0 0 0 0 2 2 0 0 0 0 0 0 0 2 
2 0 0 0 0 0 2 3 0 0 0 0 0 2 2 0 0 0 0 2 2 2 2 
2 2 2 0 0 2 2 0 0 0 0 0 0 0 0 0 0 0 0 0 0 0 2 
2 3 0 0 0 0 0 0 0 0 0 0 0 0 0 0 0 0 0 0 0 0 2 
2 0 0 0 0 0 0 0 1 1 0 0 2 0 0 0 0 0 0 0 0 3 2 
2 0 0 0 1 1 0 0 0 0 0 0 0 0 0 0 1 1 0 0 0 0 2 
2 0 0 0 1 1 0 0 0 0 0 5 0 0 0 0 1 1 0 0 0 0 2 
2 0 0 0 0 0 0 0 0 0 0 1 1 1 0 0 0 0 0 0 0 0 2 
2 3 0 0 0 0 0 0 0 0 0 1 4 1 0 0 0 0 0 0 0 0 2 
2 2 2 2 2 2 2 2 2 2 2 2 2 2 2 2 2 2 2 2 2 2 2 
